####################
#..................#
#..................#
#.....##....##.....#
#.....#.....#......#
#..E..#.....#..E...#
#.....##....##.....#
#..................#
#..................#
#..................#
#S.................#
#..................#
#.....##....##.....#
#.....#..E..#......#
#.....#.....#......#
#.....##....##.....#
#..................#
#.............B....#
#..................#
####################
---
S 1 10 data/maps/mapa_norte.txt 17 10