####################
#..................#
#..................#
#..###...###.......#
#..#.......#.......#
#..#...E...#.......#
#..###...###.......#
#..................#
#....E.............#
#..................#
#.................S#
#..................#
#.........E........#
#..................#
#..###...###.......#
#..#.......#.......#
#..#.......#...B...#
#..###...###.......#
#..................#
####################
---
S 18 10 data/maps/mapa_nordeste.txt 2 10