###########################
#&&&&&+&&&.....&&&+&&&&&&&#
<...,..+...E...+...,....&&#
#&&&&&+&&&.E...&&&+&&&&&&&#
#_____+_____?___+_________#
#...E.+.&&&&&&&&+....E....#
#....?+.&&++++&&+.........#
#.....+.&&+..+&&+.........#
#.....+..&&..&&.+....E....#
#_____+_____?___+_________#
#&&&&&+&&&.....&&&+&&&&&&&#
#.....+....E...+..........#
#&&&&&+&&&.....&&&+&&&&&&&#
#...E.....?.E......E......#
###########################
---
S 0 2 data/maps/mapa_centro_oeste.txt 48 7